4 158 200 158 305 311 305 311 200 
4 269 456 269 575 412 575 412 456 
4 849 355 849 475 994 475 994 355 
6 563 226 564 322 647 332 716 293 685 201 624 181 
6 582 625 594 683 666 730 714 715 750 594 625 537 
5 832 213 859 276 930 249 933 194 873 157 
4 272 747 358 806 446 779 396 701 
